3 3 3 3 3 3 3 3 3 3 3 3 3 3 3 3 3 3 3 3 3 3 3 3 3 3 3 3 3 3 
4 4 4 4 4 4 4 4 4 4 4 4 4 4 4 4 4 4 4 4 4 4 4 4 4 4 4 4 4 4
3 3 3 3 3 3 3 3 3 3 3 3 3 3 3 3 3 3 3 3 3 3 3 3 3 3 3 3 5 5
3 3 3 3 3 3 3 3 3 3 3 3 3 3 0 0 3 3 3 3 0 0 3 3 3 3 3 3 5 5
3 3 3 3 3 3 0 0 3 3 3 3 0 0 1 1 3 3 3 3 1 1 3 3 3 3 3 3 5 5
3 3 3 3 3 3 1 1 3 3 3 3 1 1 2 2 3 3 3 3 2 2 3 3 3 3 3 3 5 5
3 3 3 3 3 3 2 2 3 3 3 3 2 2 3 3 3 3 3 3 3 3 3 3 3 3 3 3 5 5
3 3 3 3 3 3 3 3 3 3 3 3 3 3 3 3 3 3 3 3 3 3 3 3 3 3 3 3 5 5
3 3 3 3 3 3 3 3 3 3 3 3 3 3 4 5 5 5 5 5 5 5 3 3 3 3 3 3 5 5
3 3 3 3 3 3 4 5 5 5 5 5 5 5 3 3 3 3 3 3 5 5 3 3 3 3 3 3 5 5
4 4 4 4 4 4 4 5 3 3 3 3 3 3 5 5 3 3 3 3 3 3 5 5 3 3 3 3 3 3 
4 4 4 4 4 4 5 5 3 3 3 3 3 3 5 5 3 3 3 3 3 3 5 5 3 3 3 3 3 3 
3 3 3 3 3 3 5 5 3 3 3 3 3 3 5 5 3 3 3 3 3 3 5 5 3 3 3 3 3 3 

